16 16 16 16 16 16 16 16 16 16 16 16 16 16 16 16 16 16 16 16 16 16 16 16 16 16 16 16 16 16 16 16 16 16 16 16 16 16 16 16 16 16 16 16 16 16 16 16 16 16 
16 16 16 16 16 16 16 16 16 16 16 16 16 16 16 16 16 16 16 16 16 16 16 16 16 16 16 16 16 16 16 16 16 16 16 16 16 16 16 16 16 16 16 16 16 16 16 16 16 16 
16 16 16 16 16 16 16 16 16 16 16 16 16 16 16 16 16 16 16 16 16 16 16 16 16 16 16 16 16 16 16 16 16 16 16 16 16 16 16 16 16 16 16 16 16 16 16 16 16 16 
16 16 16 16 16 16 16 16 16 16 16 16 16 16 16 16 16 16 16 16 16 16 16 16 16 16 16 16 16 16 16 16 16 16 16 16 16 16 16 16 16 16 16 16 16 16 16 16 16 16 
16 16 16 16 16 16 16 16 16 16 16 16 16 16 16 16 16 16 16 16 16 16 16 16 16 16 16 16 16 16 16 16 16 16 16 16 16 16 16 16 16 16 16 16 16 16 16 16 16 16 
16 16 16 16 16 16 16 16 16 16 16 16 16 16 16 16 16 16 16 16 16 16 16 16 16 16 16 16 16 16 16 16 16 16 16 16 16 16 16 16 16 16 16 16 16 16 16 16 16 16 
16 16 16 16 16 16 16 16 16 16 16 16 16 16 16 16 16 16 16 16 16 16 16 16 16 16 16 16 16 16 16 16 16 16 16 16 16 16 16 16 16 16 16 16 16 16 16 16 16 16 
16 16 16 16 16 16 0 1 1 1 1 1 1 1 2 16 16 16 16 16 16 16 16 16 16 16 16 16 16 16 16 16 16 16 16 16 16 16 16 16 16 16 16 16 16 16 16 16 16 16 
16 16 16 16 16 16 10 35 35 23 23 23 11 36 12 16 16 0 1 1 1 1 1 1 1 1 1 1 1 1 1 1 1 1 1 1 1 1 1 1 1 1 2 16 16 16 16 16 16 16 
16 16 16 16 16 16 10 45 45 23 30 23 24 11 12 16 16 10 33 34 33 34 33 34 11 35 11 33 34 11 11 33 34 35 33 34 28 33 34 35 35 28 12 16 16 16 16 16 16 16 
16 16 16 16 16 16 10 33 34 23 30 23 11 3 22 16 16 10 43 44 43 44 43 44 36 45 11 43 44 32 11 43 44 45 43 44 23 43 44 45 45 35 12 16 16 16 16 16 16 16 
16 16 16 16 16 16 10 43 44 37 11 30 32 12 16 16 16 10 11 11 40 42 40 40 40 40 40 40 11 11 11 11 11 11 35 23 23 23 11 36 28 45 12 16 16 16 16 16 16 16 
16 16 16 16 16 16 10 35 11 30 30 11 31 46 47 47 47 48 11 11 40 40 11 11 11 11 11 40 40 11 11 37 11 11 45 35 24 11 11 11 33 34 12 16 16 16 16 16 16 16 
16 16 16 16 16 16 10 45 35 31 32 30 3 22 16 16 16 10 11 40 40 40 40 32 40 40 40 42 11 11 11 11 11 11 11 45 35 11 36 11 43 44 12 16 16 16 16 16 16 16 
16 16 16 16 16 16 10 35 45 11 32 30 12 16 16 16 16 20 4 40 40 31 11 30 41 11 11 40 11 30 11 11 11 11 11 11 45 31 11 11 35 28 12 16 16 16 16 16 16 16 
16 16 16 16 16 16 10 45 11 31 3 21 22 16 16 16 16 16 10 40 40 11 11 41 40 38 30 11 32 11 30 11 11 35 11 11 11 11 11 11 45 35 12 16 16 16 16 16 16 16 
16 16 16 16 16 16 20 21 21 29 22 16 0 1 1 2 16 16 10 40 40 41 31 41 40 40 40 32 11 24 11 37 11 45 11 11 11 31 11 11 35 45 12 16 16 16 16 16 16 16 
16 16 16 16 16 16 16 16 16 39 16 16 10 50 40 12 16 16 10 11 11 11 11 38 40 40 40 24 37 3 21 21 21 21 21 4 31 31 11 37 45 35 12 16 16 16 16 16 16 16 
16 16 16 16 16 16 16 16 16 39 16 16 10 51 30 46 47 47 48 37 23 23 11 31 11 11 35 28 35 12 16 16 16 16 16 10 35 31 31 11 35 45 12 16 16 16 16 16 16 16 
16 16 16 16 16 16 16 16 16 39 16 16 10 30 40 12 16 16 20 21 4 23 11 11 37 11 45 35 45 12 16 16 16 16 16 10 45 35 11 11 45 28 12 16 16 16 16 16 16 16 
16 16 16 16 16 16 16 16 0 49 2 16 20 21 21 22 16 16 16 16 10 23 11 11 31 11 36 45 3 22 16 16 16 16 16 10 35 45 11 3 21 21 22 16 16 16 16 16 16 16 
16 16 16 16 16 16 16 0 14 11 13 2 16 16 16 16 16 16 16 16 20 21 21 4 31 31 11 3 22 16 16 16 16 16 0 14 45 37 11 13 1 2 16 16 16 16 16 16 16 16 
16 16 16 16 16 16 16 10 37 11 36 12 16 16 0 1 1 1 2 16 16 16 16 10 11 40 3 22 16 16 16 16 0 1 14 33 34 40 40 11 35 12 16 16 16 16 16 16 16 16 
16 16 16 16 16 16 16 10 11 11 11 46 47 47 48 11 37 37 12 16 16 16 0 14 11 32 46 47 47 47 47 47 48 11 11 43 44 11 40 11 45 12 16 16 16 16 16 16 16 16 
16 16 16 16 16 16 16 20 21 21 21 22 16 16 20 21 21 21 22 16 16 16 10 11 40 11 12 16 16 16 16 0 14 28 11 31 40 11 11 11 35 12 16 16 16 16 16 16 16 16 
16 16 16 16 16 16 16 16 16 16 16 16 16 16 16 16 16 16 16 16 16 0 14 11 40 3 22 16 16 16 0 14 33 34 35 40 40 40 11 23 45 12 16 16 16 16 16 16 16 16 
16 16 16 16 16 16 16 0 1 1 1 1 1 1 1 1 1 1 1 1 1 14 11 11 11 12 16 16 16 0 14 37 43 44 45 40 40 40 11 33 34 12 16 16 16 16 16 16 16 16 
16 16 16 16 16 16 16 10 33 34 35 35 33 34 23 23 23 35 11 11 40 40 11 40 40 12 16 16 16 10 23 33 34 35 11 40 40 40 11 43 44 12 16 16 16 16 16 16 16 16 
16 16 16 16 16 16 16 10 43 44 45 45 43 44 23 23 23 45 11 11 40 40 11 11 40 12 16 16 16 10 23 43 44 45 11 32 11 40 11 11 35 12 16 16 16 16 16 16 16 16 
16 16 16 16 16 16 16 10 37 11 11 11 11 11 11 11 40 11 11 11 11 11 40 23 23 12 16 16 16 10 35 33 34 24 11 11 11 32 11 11 45 12 16 16 16 16 16 16 16 16 
16 16 16 16 16 16 16 10 11 11 11 11 32 11 37 11 11 40 32 11 11 36 23 23 3 22 16 16 16 10 45 43 44 11 37 40 40 11 11 23 35 12 16 16 16 16 16 16 16 16 
16 16 16 16 16 16 16 10 28 28 37 31 32 11 37 11 11 11 11 11 11 23 23 3 22 16 16 16 0 14 11 11 11 11 11 40 11 37 11 11 45 12 16 16 16 16 16 16 16 16 
16 16 16 16 16 16 16 10 33 34 11 11 31 31 11 32 11 37 40 11 37 23 3 22 16 16 16 0 14 11 11 31 11 31 31 40 11 11 11 23 28 12 16 16 16 16 16 16 16 16 
16 16 16 16 16 16 16 10 43 44 11 31 11 31 11 31 11 40 40 23 23 23 12 16 16 16 0 14 11 38 31 31 11 32 31 31 32 11 11 24 11 12 16 16 16 16 16 16 16 16 
16 16 16 16 16 16 16 10 11 11 11 11 11 11 11 11 11 28 3 21 21 29 22 16 16 16 10 28 11 31 11 31 37 35 35 35 35 35 35 33 34 12 16 16 16 16 16 16 16 16 
16 16 16 16 16 16 16 10 11 11 11 40 41 42 40 40 11 35 13 1 1 49 1 1 2 16 10 37 11 42 32 33 34 45 45 45 45 45 45 43 44 12 16 16 16 16 16 16 16 16 
16 16 16 16 16 16 16 10 11 11 36 11 11 11 11 11 11 45 23 23 23 23 23 23 12 16 10 35 11 37 11 43 44 31 32 30 31 31 11 11 23 12 16 16 16 16 16 16 16 16 
16 16 16 16 16 16 16 10 23 11 11 11 40 40 40 40 11 11 30 30 11 11 11 23 12 16 10 45 11 32 11 31 31 40 11 31 30 30 31 11 35 12 16 16 16 16 16 16 16 16 
16 16 16 16 16 16 16 10 23 11 11 40 11 40 36 40 40 30 11 11 11 11 32 23 12 16 20 4 11 11 11 31 31 42 40 31 30 30 11 30 45 12 16 16 16 16 16 16 16 16 
16 16 16 16 16 16 16 10 23 33 34 35 33 34 35 11 11 35 11 11 30 11 11 23 12 16 16 20 4 11 11 33 34 28 35 35 35 33 34 35 35 12 16 16 16 16 16 16 16 16 
16 16 16 16 16 16 16 10 28 43 44 45 43 44 45 11 11 45 23 23 23 23 23 23 12 16 16 16 20 4 11 43 44 32 45 45 45 43 44 45 45 12 16 16 16 16 16 16 16 16 
16 16 16 16 16 16 16 20 21 21 21 21 21 21 21 21 21 21 21 21 21 21 21 21 22 16 16 16 16 20 21 21 21 21 21 21 21 21 21 21 21 22 16 16 16 16 16 16 16 16 
16 16 16 16 16 16 16 16 16 16 16 16 16 16 16 16 16 16 16 16 16 16 16 16 16 16 16 16 16 16 16 16 16 16 16 16 16 16 16 16 16 16 16 16 16 16 16 16 16 16 
16 16 16 16 16 16 16 16 16 16 16 16 16 16 16 16 16 16 16 16 16 16 16 16 16 16 16 16 16 16 16 16 16 16 16 16 16 16 16 16 16 16 16 16 16 16 16 16 16 16 
16 16 16 16 16 16 16 16 16 16 16 16 16 16 16 16 16 16 16 16 16 16 16 16 16 16 16 16 16 16 16 16 16 16 16 16 16 16 16 16 16 16 16 16 16 16 16 16 16 16 
16 16 16 16 16 16 16 16 16 16 16 16 16 16 16 16 16 16 16 16 16 16 16 16 16 16 16 16 16 16 16 16 16 16 16 16 16 16 16 16 16 16 16 16 16 16 16 16 16 16 
16 16 16 16 16 16 16 16 16 16 16 16 16 16 16 16 16 16 16 16 16 16 16 16 16 16 16 16 16 16 16 16 16 16 16 16 16 16 16 16 16 16 16 16 16 16 16 16 16 16 
16 16 16 16 16 16 16 16 16 16 16 16 16 16 16 16 16 16 16 16 16 16 16 16 16 16 16 16 16 16 16 16 16 16 16 16 16 16 16 16 16 16 16 16 16 16 16 16 16 16 
16 16 16 16 16 16 16 16 16 16 16 16 16 16 16 16 16 16 16 16 16 16 16 16 16 16 16 16 16 16 16 16 16 16 16 16 16 16 16 16 16 16 16 16 16 16 16 16 16 16 
16 16 16 16 16 16 16 16 16 16 16 16 16 16 16 16 16 16 16 16 16 16 16 16 16 16 16 16 16 16 16 16 16 16 16 16 16 16 16 16 16 16 16 16 16 16 16 16 16 16 
