0 0 0 0 0 0 0 0 0 0 0 0 0 0 0 0 0 0 0 0 0 0 0 0 0
0 0 17 0 0 0 0 0 0 0 0 0 0 17 0 0 0 0 0 0 0 16 0 0 0
0 0 0 0 0 0 0 0 0 0 1 0 0 0 0 0 0 0 0 0 0 0 0 0 0
0 0 0 0 0 0 0 0 0 0 0 0 0 0 0 0 16 0 0 0 0 0 1 0 0
0 0 1 0 17 0 0 0 0 0 0 0 0 0 0 0 0 17 0 0 0 0 0 0 0
0 0 0 0 16 0 0 0 0 0 0 4 5 5 5 5 6 0 0 0 0 0 0 0 0
0 0 0 0 0 0 1 17 0 0 0 7 2 2 2 2 8 0 0 0 0 0 0 0 0
0 0 0 0 16 1 0 0 0 0 0 7 2 2 3 2 8 0 0 0 0 16 0 0 0
0 0 0 0 0 0 0 0 0 0 0 7 3 2 2 2 8 0 0 0 0 0 17 0 0
0 0 0 0 0 0 0 0 0 0 1 9 10 10 10 10 11 0 0 0 16 0 0 0 0
0 0 0 0 0 0 17 0 0 0 0 0 0 0 0 17 0 0 0 0 0 0 1 0 0
0 0 0 0 0 0 0 16 0 0 0 0 0 0 0 0 0 0 0 0 0 0 0 0 0
0 0 17 0 0 0 0 0 0 0 17 16 0 0 0 0 0 0 0 1 0 0 0 0 0
0 16 0 0 0 0 0 0 0 0 0 0 0 0 0 0 0 0 0 0 16 0 0 0 0